#######################################################################
#######################################################################
#######################################################################
#######################################################################
#######################################################################
#######################################################################
###############################.........###############################
#########################......................########################
####################..............................#####################
#################....................................##################
###############.......................................#################
################...................................####################
################...................................####################
##################..................................###################
###################...........####..................###################
#################..............####...................#################
################...............####...................#################
#################...............#.......................###############
###############........................................################
################.......................................################
#################......................................################
##################...................................##################
################.....................................##################
#################..................................####################
###################...........................#########################
###################...........................#########################
####################....................###############################
#######################..............##################################
#######################################################################
#######################################################################
#######################################################################
#######################################################################
#######################################################################
#######################################################################