##.........................................##
###...................................#######
###...................................#######
#####..................................######
######...........####..................######
####..............####...................####
###...............####...................####
####...............#.......................##
##........................................###
###.......................................###
####......................................###
#####...................................#####
###.....................................#####
####..................................#######
######...........................############
######...........................############
#######....................##################
##########..............#####################
#############################################
#############################################