DDDDDDDDDDDDDDDDDDDDDDDDDDDDDDDDDDDDDDDDDDDDDDDDDDDDDDDDDDDDDDDDDDDDDDD
DDDDDDDDDDDDDDDDDDDDDDDDDDDDDDDDDDDDDDDDDDDDDDDDDDDDDDDDDDDDDDDDDDDDDDD
DDDDDDDDDDDDDDDDDDDDDDDDDDDDDDDDDDDDDDDDDDDDDDDDDDDDDDDDDDDDDDDDDDDDDDD
DDDDDDDDDDDDDDDDDDDDDDDDDDDDDDDDDDDDDDDDDDDDDDDDDDDDDDDDDDDDDDDDDDDDDDD
DDDDDDDDDDDDDDDDDDDDDDDDDDDDDDDDDDDDDDDDDDDDDDDDDDDDDDDDDDDDDDDDDDDDDDD
DDDDDDDDDDDDDDDDDDDDDDDDDDDDDDDDDDDDDDDDDDDDDDDDDDDDDDDDDDDDDDDDDDDDDDD
DDDDDDDDDDDDDDDDDDDDDDDDDDDDDDDDDDDDDDDDDDDDDDDDDDDDDDDDDDDDDDDDDDDDDDD
DDDDDDDDDDDDDDDDDDDDDDDDDDDDDDDDDDDDDDDDDDDDDDDDDDDDDDDDDDDDDDDDDDDDDDD
DDDDDDDDDDDDDDDDDDDDDDDDDDDDDDDDDDDDDDDDDDDDDDDDDDDDDDDDDDDDDDDDDDDDDDD
DDDDDDDDDDDDDDDDDDDDDDDDDDDDDDDDDDDDDDDDDDDDDRDDDDDDDDDDDDDDDDDDDDDDDDD
DDDDDDDDRDDDDDDDDDDDDDDDDDDDDDDOOOOOOOOODDDDDDDDDDDDDDDDDDDDDDDDDDDDDDD
DDDDDDDDDDDDDDDDDDRDDDDDDOOOOOO.........OOOOOOODDDDDDDDDDDDDDDDDDDDDDDD
DDDDDDDDDDDDDDDDDDDDOOOOO......................OOODDDDDDDDDDRDDDDDDDDDD
DDDDDDDDDDDDDDDDDOOO..............................OOODDDDDDDDDDDDDDDDDD
DDDDDDDDDDDDDDDOO....................................ODDDDDDDDDDDDDDDDD
DDDDDDDDDDDDDDDg...................................grBDDDDDDDDDDDDDDDDD
DDDDDDDDDDDDDDDS...................................SSSDDDDDDDDDDDDDDDDD
DDDDDDDDDDDDDDDDgg.................................ODDDDDDDDDDDDDDDDDDD
DDDDDDDDDDDDDDDDSSg...........grgg..................DDDDDDDDDDDDDDDDDDD
DDDDDDDDDDRDDDDDDDS...........SSSSg.................OODDDDDDDDDDDDDDDDD
DDDDDDDDDDDDDDDDO.............ODDDS...................DDDDDDDDDDDDDDDDD
DDDDDDDDDDDDDDDDg..............ODOO................p..OODDDDDDDDDDDDDDD
DDDDDDDDDDDDDDDDS...............O..................t...gDDDDDDDDDDDDDDD
DDDDDDDDDDDDDDDg...p...............................t...SDDDDDDDDDDDDDDD
DDDDDDDDDDDDDDDSg..t...............................t...DDDDDDDDDDDDDDDD
DDDDDDDDDDDDDDDDSg.t...............................t.gBDDDDDDDDDDDDDDDD
DDDDDDDDDDDDDDDDDS.t.....................p.........t.SSDDDDDDRDDDDDDDDD
DDDDDDDDDDDDDDDDg..t.....................t.........bgDDDDDDDDDDDDDDDDDD
DDDDDDDDDDDDDDDDSBgt.....................t....gggrgSSDDDDDDDDDDDDDDDDDD
DDDDDDDDDRDDDDDDDSSt.....................t....SSSSSDDDDDDDDDDDDDDDDDDDD
DDDDDDDDDDDDDDDDDDDb....p...............gbgggBDDDDRDDDDDDDDDDDDDDDDDDDD
DDDDDDDDDDDDDDDDDDDSggg.t............gggSSSSSSDDDDDDDDDDDDDDDDDDDDDDDDD
DDDDDDDDDDDDDDDDDDDDSSSgbrggggBggggggSSSDDDDDDDDDDDDDDDDDDDDDDDDDDDDDDD
DDDDDDDDDDDDDDDDRDDDDDDSSSSSSSSSSSSSSDDDDDDDDDDDDDDDDDDDDDDDDDDDDDDDDDD
DDDDDDDDDDDDDDDDDDDDDDDDDDDDDDDDDDDDDDDDDDDDDDDDDDDDDDDDDDDDDDDDDDDDDDD
DDDDDDDDDDDDDDDDDDDDDDDDDDDDRDDDDDDDDDDDDDDDDDDDRDDDDDDDDDDDDDDDDDDDDDD
DDDDDDDDDDDDDDDDDDDDDDDDDDDDDDDDDDDDDDDDDDDDDDDDDDDDDDDDDDDDDDDDDDDDDDD
DDDDDDDDDDDDDDDDDDDDDDDDDDDDDDDDDDDDDDRDDDDDDDDDDDDDDDDDDDDDDDDDDDDDDDD
DDDDDDDDDDDRDDDDDDDDDDDDDDDDDDDDDDDDDDDDDDDDDDDDDDDDDDDDDDDDDDDDDDDDDDD
DDDDDDDDDDDDDDDDDDDDDDDDDDDDDDDDDDDDDDDDDDDDDDDDDDDDDDDDDDDDDDDDDDDDDDD
DDDDDDDDDDDDDDDDDDDDDDDDDDDDDDDDDDDDDDDDDDDDDDDDDDDDDDDDDDDDDDDDDDDDDDD
DDDDDDDDDDDDDDDDDDDDDDDDDDDDDDDDDDDDDDDDDDDDDDDDDDDDDDDDDDDDDDDDDDDDDDD
DDDDDDDDDDDDDDDDDDDDDDDDDDDDDDDDDDDDDDDDDDDDDDDDDDDDDDDDDDDDDDDDDDDDDDD
DDDDDDDDDDDDDDDDDDDDDDDDDDDDDDDDDDDDDDDDDDDDDDDDDDDDDDDDDDDDDDDDDDDDDDD