DDDDDDDDDDDDDDDDDDDDDDDDDDDDDDDDDDDDDDDDDDDDDDDDDDDDDDDDDDDDDDDDDDDDDDD
DDDDDDDDDDDDDDDDDDDDDDDDDDDDDDDDDDDDDDDDDDDDDDDDDDDDDDDDDDDDDDDDDDDDDDD
DDDDDDDDDDDDDDDDDDDDDDDDDDDDDDDDDDDDDDDDDDDDDDDDDDDDDDDDDDDDDDDDDDDDDDD
DDDDDDDDDDDDDDDDDDDDDDDDDDDDDDDDDDDDDDDDDDDDDDDDDDDDDDDDDDDDDDDDDDDDDDD
DDDDDDDDDDDDDDDDDDDDDDDDDDDDDDDDDDDDDDDDDDDDDDDDDDDDDDDDDDDDDDDDDDDDDDD
DDDDDDDDDDDDDDDDDDDDDDDDDDDDDDDDDDDDDDDDDDDDDDDDDDDDDDDDDDDDDDDDDDDDDDD
DDDDDDDDDDDDDDDDDDDDDDDDDDDDDDDDDDDDDDDDDDDDDDDDDDDDDDDDDDDDDDDDDDDDDDD
DDDDDDDDDDDDDDDDDDDDDDDDDDDDDDDDDDDDDDDDDDDDDDDDDDDDDDDDDDDDDDDDDDDDDDD
DDDDDDDDDDDDDDDDDDDDDDDDDDDDDDDDDDDDDDDDDDDDDDDDDDDDDDDDDDDDDDDDDDDDDDD
DDDDDDDDDDDDDDDDDDDDDDDDDDDDDDDDDDDDDDDDDDDDDRDDDDDDDDDDDDDDDDDDDDDDDDD
DDDDDDDDRDDDDDDDDDDDDDDDDDDDDDDOOOOOOOOODDDDDDDDDDDDDDDDDDDDDDDDDDDDDDD
DDDDDDDDDDDDDDDDDDRDDDDDDOOOOOO.........OOOOOOODDDDDDDDDDDDDDDDDDDDDDDD
DDDDDDDDDDDDDDDDDDDDOOOOO......................OOODDDDDDDDDDRDDDDDDDDDD
DDDDDDDDDDDDDDDDDOOO...........234................OOODDDDDDDDDDDDDDDDDD
DDDDDDDDDDDDDDDOO..............1p5...................ODDDDDDDDDDDDDDDDD
DDDDDDDDDDDDDDDg................t..................grBDDDDDDDDDDDDDDDDD
DDDDDDDDDDDDDDDS................t..................SSSDDDDDDDDDDDDDDDDD
DDDDDDDDDDDDDDDDgg..............t..................ODDDDDDDDDDDDDDDDDDD
DDDDDDDDDDDDDDDDSSg...........grbg..................DDDDDDDDDDDDDDDDDDD
DDDDDDDDDDRDDDDDDDS...........SSSSg.................OODDDDDDDDDDDDDDDDD
DDDDDDDDDDDDDDDDO.............ODDDS...............234.DDDDDDDDDDDDDDDDD
DDDDDDDDDDDDDDDDg..............ODOO...............1p5.OODDDDDDDDDDDDDDD
DDDDDDDDDDDDDDDDS.234...........O..................t...gDDDDDDDDDDDDDDD
DDDDDDDDDDDDDDDg..1p5..............................t...SDDDDDDDDDDDDDDD
DDDDDDDDDDDDDDDSg..t...............................t...DDDDDDDDDDDDDDDD
DDDDDDDDDDDDDDDDSg.t....................234........t.gBDDDDDDDDDDDDDDDD
DDDDDDDDDDDDDDDDDS.t....................1p5........t.SSDDDDDDRDDDDDDDDD
DDDDDDDDDDDDDDDDg..t.....................t.........bgDDDDDDDDDDDDDDDDDD
DDDDDDDDDDDDDDDDSBgt.....................t....gggrgSSDDDDDDDDDDDDDDDDDD
DDDDDDDDDRDDDDDDDSSt...234...............t....SSSSSDDDDDDDDDDDDDDDDDDDD
DDDDDDDDDDDDDDDDDDDb...1p5..............gbgggBDDDDRDDDDDDDDDDDDDDDDDDDD
DDDDDDDDDDDDDDDDDDDSggg.t............gggSSSSSSDDDDDDDDDDDDDDDDDDDDDDDDD
DDDDDDDDDDDDDDDDDDDDSSSgbrggggBggggggSSSDDDDDDDDDDDDDDDDDDDDDDDDDDDDDDD
DDDDDDDDDDDDDDDDRDDDDDDSSSSSSSSSSSSSSDDDDDDDDDDDDDDDDDDDDDDDDDDDDDDDDDD
DDDDDDDDDDDDDDDDDDDDDDDDDDDDDDDDDDDDDDDDDDDDDDDDDDDDDDDDDDDDDDDDDDDDDDD
DDDDDDDDDDDDDDDDDDDDDDDDDDDDRDDDDDDDDDDDDDDDDDDDRDDDDDDDDDDDDDDDDDDDDDD
DDDDDDDDDDDDDDDDDDDDDDDDDDDDDDDDDDDDDDDDDDDDDDDDDDDDDDDDDDDDDDDDDDDDDDD
DDDDDDDDDDDDDDDDDDDDDDDDDDDDDDDDDDDDDDRDDDDDDDDDDDDDDDDDDDDDDDDDDDDDDDD
DDDDDDDDDDDRDDDDDDDDDDDDDDDDDDDDDDDDDDDDDDDDDDDDDDDDDDDDDDDDDDDDDDDDDDD
DDDDDDDDDDDDDDDDDDDDDDDDDDDDDDDDDDDDDDDDDDDDDDDDDDDDDDDDDDDDDDDDDDDDDDD
DDDDDDDDDDDDDDDDDDDDDDDDDDDDDDDDDDDDDDDDDDDDDDDDDDDDDDDDDDDDDDDDDDDDDDD
DDDDDDDDDDDDDDDDDDDDDDDDDDDDDDDDDDDDDDDDDDDDDDDDDDDDDDDDDDDDDDDDDDDDDDD
DDDDDDDDDDDDDDDDDDDDDDDDDDDDDDDDDDDDDDDDDDDDDDDDDDDDDDDDDDDDDDDDDDDDDDD
DDDDDDDDDDDDDDDDDDDDDDDDDDDDDDDDDDDDDDDDDDDDDDDDDDDDDDDDDDDDDDDDDDDDDDD